111111111
111s11111
111111111
111111111
111111N11
111111111
111111S11
111111111
111111111
