NO ./textures/wall1
SO ./textures/wall1
EA ./textures/wall2
WE ./textures/wall2

C 235,115,115
F 97,247,67

111111111111111111111111
100000000000000000000001
100000000000000000000001
100000000000000000000001
100000111110000101010001
100000100010000000000001
1000001000S0000100110001
100000100010000000000001
100000110110000101010001
100000000000000000000001
111111111111111111111111