	NO    ./textures/theme_02/east.png
SO 					./textures/theme_02/north.png
  C		 245		,222,0		
		WE ./textures/theme_02/south.png



		F   	215,   127,80
EA ./textures/theme_02/west.png

1111111111111111111111111
1000000000110001000000001
10110000011100N1010000001 		
1001000000000001000000011
1111111110110000011100001
1000000000110000011101111
1111011111111101100000001
1111011111111101110101001
1100000011010101110000001
1000000000000000000000001
1000000000000000110101001
1100000111010101111101111
1111111111111111111111111