NO    ./textures/theme_02/east.png
SO 					./textures/theme_02/north.png
WE ./textures/theme_02/south.png
EA ./textures/theme_02/west.png

C 245,222,0
F 225,127,80

1111111111111111111111111
1000000000110000000000001
101100000111000N000000001
1001000000000000000000011
1111111110110000011100001
1000000000110000011101111
1111011111111101100000001
1111011111111101110101001
1100000011010101110000001
1000000000000000000000001
1000000000000000110101001
1100000111010101111101111
1111111111111111111111111